accesskeys	Ensures every accesskey attribute value is unique	Serious	"best-practice, cat.keyboard"
area-alt	Ensures <area> elements of image maps have alternate text	Critical	"cat.text-alternatives, wcag2a, wcag111, section508, section508.22.a"
aria-allowed-attr	Ensures ARIA attributes are allowed for an element's role	Critical	"cat.aria, wcag2a, wcag412"
aria-allowed-role	Ensures role attribute has an appropriate value for the element	Minor	"cat.aria, best-practice"
aria-dpub-role-fallback	Ensures unsupported DPUB roles are only used on elements with implicit fallback roles	Moderate	"cat.aria, wcag2a, wcag131"
aria-hidden-body	Ensures aria-hidden='true' is not present on the document body.	Critical	"cat.aria, wcag2a, wcag412"
aria-hidden-focus	Ensures aria-hidden elements do not contain focusable elements	Serious	"cat.name-role-value, wcag2a, wcag412, wcag131"
aria-input-field-name	Ensures every ARIA input field has an accessible name	"Moderate, Serious"	"wcag2a, wcag412"
aria-required-attr	Ensures elements with ARIA roles have all required ARIA attributes	Critical	"cat.aria, wcag2a, wcag412"
aria-required-children	Ensures elements with an ARIA role that require child roles contain them	Critical	"cat.aria, wcag2a, wcag131"
aria-required-parent	Ensures elements with an ARIA role that require parent roles are contained by them	Critical	"cat.aria, wcag2a, wcag131"
aria-roledescription	Ensure aria-roledescription is only used on elements with an implicit or explicit role	Serious	"cat.aria, wcag2a, wcag412"
aria-roles	Ensures all elements with a role attribute use a valid value	"Serious, Critical"	"cat.aria, wcag2a, wcag412"
aria-toggle-field-name	Ensures every ARIA toggle field has an accessible name	"Moderate, Serious"	"wcag2a, wcag412"
aria-valid-attr-value	Ensures all ARIA attributes have valid values	Critical	"cat.aria, wcag2a, wcag412"
aria-valid-attr	Ensures attributes that begin with aria- are valid ARIA attributes	Critical	"cat.aria, wcag2a, wcag412"
audio-caption	Ensures <audio> elements have captions	Critical	"cat.time-and-media, wcag2a, wcag121, section508, section508.22.a"
autocomplete-valid	Ensure the autocomplete attribute is correct and suitable for the form field	Serious	"cat.forms, wcag21aa, wcag135"
avoid-inline-spacing	Ensure that text spacing set through style attributes can be adjusted with custom stylesheets	Serious	"wcag21aa, wcag1412"
blink	Ensures <blink> elements are not used	Serious	"cat.time-and-media, wcag2a, wcag222, section508, section508.22.j"
button-name	Ensures buttons have discernible text	Critical	"cat.name-role-value, wcag2a, wcag412, section508, section508.22.a"
bypass	Ensures each page has at least one mechanism for a user to bypass navigation and jump straight to the content	Serious	"cat.keyboard, wcag2a, wcag241, section508, section508.22.o"
checkboxgroup	"Ensures related <input type=""checkbox""> elements have a group and that the group designation is consistent"	Critical	"cat.forms, best-practice, deprecated"
color-contrast	Ensures the contrast between foreground and background colors meets WCAG 2 AA contrast ratio thresholds	Serious	"cat.color, wcag2aa, wcag143"
css-orientation-lock	"Ensures content is not locked to any specific display orientation, and the content is operable in all display orientations"	Serious	"cat.structure, wcag134, wcag21aa, experimental"
definition-list	Ensures <dl> elements are structured correctly	Serious	"cat.structure, wcag2a, wcag131"
dlitem	Ensures <dt> and <dd> elements are contained by a <dl>	Serious	"cat.structure, wcag2a, wcag131"
document-title	Ensures each HTML document contains a non-empty <title> element	Serious	"cat.text-alternatives, wcag2a, wcag242"
duplicate-id-active	Ensures every id attribute value of active elements is unique	Serious	"cat.parsing, wcag2a, wcag411"
duplicate-id-aria	Ensures every id attribute value used in ARIA and in labels is unique	Critical	"cat.parsing, wcag2a, wcag411"
duplicate-id	Ensures every id attribute value is unique	Minor	"cat.parsing, wcag2a, wcag411"
empty-heading	Ensures headings have discernible text	Minor	"cat.name-role-value, best-practice"
focus-order-semantics	Ensures elements in the focus order have an appropriate role	Minor	"cat.keyboard, best-practice, experimental"
form-field-multiple-labels	Ensures form field does not have multiple label elements	Moderate	"cat.forms, wcag2a, wcag332"
frame-tested	Ensures <iframe> and <frame> elements contain the axe-core script	Critical	"cat.structure, review-item, best-practice"
frame-title-unique	Ensures <iframe> and <frame> elements contain a unique title attribute	Serious	"cat.text-alternatives, best-practice"
frame-title	Ensures <iframe> and <frame> elements contain a non-empty title attribute	Serious	"cat.text-alternatives, wcag2a, wcag241, wcag412, section508, section508.22.i"
heading-order	Ensures the order of headings is semantically correct	Moderate	"cat.semantics, best-practice"
hidden-content	Informs users about hidden content.	Minor	"cat.structure, experimental, review-item, best-practice"
html-has-lang	Ensures every HTML document has a lang attribute	Serious	"cat.language, wcag2a, wcag311"
html-lang-valid	Ensures the lang attribute of the <html> element has a valid value	Serious	"cat.language, wcag2a, wcag311"
html-xml-lang-mismatch	Ensure that HTML elements with both valid lang and xml:lang attributes agree on the base language of the page	Moderate	"cat.language, wcag2a, wcag311"
image-alt	Ensures <img> elements have alternate text or a role of none or presentation	Critical	"cat.text-alternatives, wcag2a, wcag111, section508, section508.22.a"
image-redundant-alt	Ensure image alternative is not repeated as text	Minor	"cat.text-alternatives, best-practice"
input-button-name	Ensures input buttons have discernible text	Critical	"cat.name-role-value, wcag2a, wcag412, section508, section508.22.a"
input-image-alt	"Ensures <input type=""image""> elements have alternate text"	Critical	"cat.text-alternatives, wcag2a, wcag111, section508, section508.22.a"
label-content-name-mismatch	Ensures that elements labelled through their content must have their visible text as part of their accessible name	Serious	"wcag21a, wcag253, experimental"
label-title-only	Ensures that every form element is not solely labeled using the title or aria-describedby attributes	Serious	"cat.forms, best-practice"
label	Ensures every form element has a label	"Minor, Critical"	"cat.forms, wcag2a, wcag332, wcag131, section508, section508.22.n"
landmark-banner-is-top-level	Ensures the banner landmark is at top level	Moderate	"cat.semantics, best-practice"
landmark-complementary-is-top-level	Ensures the complementary landmark or aside is at top level	Moderate	"cat.semantics, best-practice"
landmark-contentinfo-is-top-level	Ensures the contentinfo landmark is at top level	Moderate	"cat.semantics, best-practice"
landmark-main-is-top-level	Ensures the main landmark is at top level	Moderate	"cat.semantics, best-practice"
landmark-no-duplicate-banner	Ensures the document has at most one banner landmark	Moderate	"cat.semantics, best-practice"
landmark-no-duplicate-contentinfo	Ensures the document has at most one contentinfo landmark	Moderate	"cat.semantics, best-practice"
landmark-one-main	Ensures the document has only one main landmark and each iframe in the page has at most one main landmark	Moderate	"cat.semantics, best-practice"
landmark-unique	Landmarks must have a unique role or role/label/title (i.e. accessible name) combination	Moderate	"cat.semantics, best-practice"
layout-table	"Ensures presentational <table> elements do not use <th>, <caption> elements or the summary attribute"	Serious	"cat.semantics, wcag2a, wcag131"
link-in-text-block	Links can be distinguished without relying on color	Serious	"cat.color, experimental, wcag2a, wcag141"
link-name	Ensures links have discernible text	Serious	"cat.name-role-value, wcag2a, wcag412, wcag244, section508, section508.22.a"
list	Ensures that lists are structured correctly	Serious	"cat.structure, wcag2a, wcag131"
listitem	Ensures <li> elements are used semantically	Serious	"cat.structure, wcag2a, wcag131"
marquee	Ensures <marquee> elements are not used	Serious	"cat.parsing, wcag2a, wcag222"
meta-refresh	"Ensures <meta http-equiv=""refresh""> is not used"	Critical	"cat.time, wcag2a, wcag2aaa, wcag221, wcag224, wcag325"
meta-viewport-large	"Ensures <meta name=""viewport""> can scale a significant amount"	Minor	"cat.sensory-and-visual-cues, best-practice"
meta-viewport	"Ensures <meta name=""viewport""> does not disable text scaling and zooming"	Critical	"cat.sensory-and-visual-cues, wcag2aa, wcag144"
object-alt	Ensures <object> elements have alternate text	Serious	"cat.text-alternatives, wcag2a, wcag111, section508, section508.22.a"
p-as-heading	Ensure p elements are not used to style headings	Serious	"cat.semantics, wcag2a, wcag131, experimental"
page-has-heading-one	"Ensure that the page, or at least one of its frames contains a level-one heading"	Moderate	"cat.semantics, best-practice"
radiogroup	"Ensures related <input type=""radio""> elements have a group and that the group designation is consistent"	Critical	"cat.forms, best-practice, deprecated"
region	Ensures all page content is contained by landmarks	Moderate	"cat.keyboard, best-practice"
role-img-alt	Ensures [role='img'] elements have alternate text	Serious	"cat.text-alternatives, wcag2a, wcag111, section508, section508.22.a"
scope-attr-valid	Ensures the scope attribute is used correctly on tables	"Moderate, Critical"	"cat.tables, best-practice"
scrollable-region-focusable	Elements that have scrollable content should be accessible by keyboard	Moderate	"wcag2a, wcag211"
server-side-image-map	Ensures that server-side image maps are not used	Minor	"cat.text-alternatives, wcag2a, wcag211, section508, section508.22.f"
skip-link	Ensure all skip links have a focusable target	Moderate	"cat.keyboard, best-practice"
tabindex	Ensures tabindex attribute values are not greater than 0	Serious	"cat.keyboard, best-practice"
table-duplicate-name	Ensure that tables do not have the same summary and caption	Minor	"cat.tables, best-practice"
table-fake-caption	Ensure that tables with a caption use the <caption> element.	Serious	"cat.tables, experimental, wcag2a, wcag131, section508, section508.22.g"
td-has-header	Ensure that each non-empty data cell in a large table has one or more table headers	Critical	"cat.tables, experimental, wcag2a, wcag131, section508, section508.22.g"
td-headers-attr	Ensure that each cell in a table using the headers refers to another cell in that table	Serious	"cat.tables, wcag2a, wcag131, section508, section508.22.g"
th-has-data-cells	Ensure that each table header in a data table refers to data cells	Serious	"cat.tables, wcag2a, wcag131, section508, section508.22.g"
valid-lang	Ensures lang attributes have valid values	Serious	"cat.language, wcag2aa, wcag312"
video-caption	Ensures <video> elements have captions	Critical	"cat.text-alternatives, wcag2a, wcag122, section508, section508.22.a"
video-description	Ensures <video> elements have audio descriptions	Critical	"cat.text-alternatives, wcag2aa, wcag125, section508, section508.22.b, deprecated"
